The next item is the vote.	The next item is the vote.
(For the results and other details on the vote: see Minutes)	(For the results and other details on the vote: see Minutes)
Corrections to votes and voting intentions: see Minutes	Balsavimo ketinimai ir pataisymai (žr. protokolą)
Council position at first reading: see Minutes	Tarybos pozicija pirmojo svarstymo metu (žr. protokola)
Decisions concerning certain documents: see Minutes	Sprendimai dėl kai kurių dokumentų (žr. protokolą)
Written declarations included in the register (Rule 123): see Minutes	Į registrą įrašyti rašytiniai pareiškimai (Darbo tvarkos taisyklių 123 straipsnis) (žr. protokola)
Forwarding of texts adopted during the sitting : see Minutes	Posėdžio metu priimtų tekstų perdavimas (žr. protokola)
Dates of forthcoming sittings: see Minutes	Kitų posėdžių kalendorinis planas (žr. protokolą)
Adjournment of the session	Sesijos atidėjimas
Resumption of the session	Sesijos atnaujinimas
Ogłaszam wznowienie sesji Parlamentu Europejskiego przerwanej w czwartek, 27 października 2011 r.	Ogłaszam wznowienie sesji Parlamentu Europejskiego przerwanej w czwartek, 27 października 2011 r.
Compatibility of the Anti-Counterfeiting Trade Agreement with the EU Charter of Fundamental Rights: see Minutes	Prekybos susitarimo dėl kovos su klastojimu suderinamumas Europos Sąjungos pagrindinių teisių chartija (žr. protokola)
Composition of political groups : see Minutes	Frakcijų sudėtis (žr. protokola)
Signature of acts adopted under the ordinary legislative procedure: see Minutes	Pagal įprastą teisėkūros procedūrą priimtų teisės aktų pasirašymas (žr. protokola)
Documents received: see Minutes	Pateikti dokumentai (žr.protokolą)
Oral questions and written declarations (submission): see Minutes	Klausimai, į kuriuos atsakoma žodžiu, ir rašytiniai pareiškimai (gauti dokumentai) (žr. protokola)
Lapsed written declarations: see Minutes	Anuliuoti rašytiniai pareiškimai (žr. protokola)
Texts of agreements forwarded by the Council: see Minutes	Tarybos perduoti susitarimų tekstai (žr. protokolą)
Action taken on Parliament's resolutions: see Minutes	Veiksmai įgyvendinant Parlamento rezoliucijas (žr. protokola)
Transfers of appropriations: see Minutes	Asignavimų perkėlimas (žr. protokolą)
Petitions: see Minutes	Peticijos (žr. protokolą)
Dates of forthcoming sittings	Kitų posėdžių kalendorinis planas
Closure of the sitting	Posėdžio pabaiga
Opening of the sitting	Posėdžio pradžia
Documents received: see Minutes	Pateikti dokumentai (žr.protokolą)
Debates on cases of breaches of human rights, democracy and the rule of law (announcement of motions for resolutions tabled): see Minutes	Diskusijos dėl žmogaus teisių, demokratijos ir teisinės valstybės pažeidimo atvejų (paskelbiami pateikti pasiūlymai dėl rezoliucijų) (žr. protokolą)
1.	1.
Coordination of safeguards required of companies (Article 54 TFEU) (C7-0037/2011) (vote)	Apsaugos priemonių, kurių reikalaujama iš bendrovių, koordinavimas (SESV 54 straipsnis) (C7-0037/2011) (balsavimas)
2.	2.
Athens Convention on carriage of passengers and their luggage by sea - excluding Articles 10 and 11 (	Atėnų konvencija dėl keleivių ir jų bagažo vežimo jūra, išskyrus 10 ir 11 straipsnius (
3.	3.
Athens Convention on carriage of passengers and their luggage by sea - as regards Articles 10 and 11 (	Atėnų konvencija dėl keleivių ir jų bagažo vežimo jūra. Klausimai, susiję su 10 ir 11 straipsniais (
4.	4.
EU-Jordan Euro-Mediterranean aviation agreement (	ES ir Jordanijos Europos ir Viduržemio jūros regiono šalių aviacijos susitarimas (
5.	5.
EU-Georgia common aviation area agreement (	ES ir Gruzijos bendrosios aviacijos erdvės susitarimas (
6.	6.
Temporary suspension of autonomous Common Customs Tariff duties on imports of certain industrial products into the Canary Islands (	Laikinas autonominių Bendrojo muitų tarifo muitų taikymo tam tikriems į Kanarų salas importuojamiems pramonės produktams sustabdymas (
7.	7.
Framework programme of the European Atomic Energy Community for nuclear research and training activities (indirect actions) (	Europos atominės energijos bendrijos branduolinių mokslinių tyrimų ir mokymo veiklos bendrosios programos įgyvendinimas (netiesioginiai veiksmai) (
8.	8.
Insolvency proceedings in the context of EU company law (	Nemokumo bylos remiantis ES įmonių teisės nuostatomis (
9.	9.
Demographic change and its consequences for the cohesion policy (	Demografiniai pokyčiai ir jų padariniai sanglaudos politikai (
11.	11.
European statistics on permanent crops (	Europos daugiamečių kultūrų statistika (
12.	12.
Framework programme of the European Atomic Energy Community for nuclear research and training activities (direct actions) (	Europos atominės energijos bendrijos branduolinių mokslinių tyrimų ir mokymo veiklos bendroji programa (tiesioginiai veiksmai) (
13.	13.
Participation of undertakings, research centres and universities in indirect actions under the framework programme of the European Atomic Energy Community (	Įmonių, mokslinių tyrimų centrų ir universitetų dalyvavimas vykdant netiesioginius veiksmus pagal Europos atominės energijos bendrijos bendrąją programą (
14.	14.
Implementation of Professional Qualifications Directive (	Direktyvos dėl profesinių kvalifikacijų pripažinimo įgyvendinimas (
15.	15.
Consumer policy (	Vartotojų politika (
16.	16.
Online gambling (	Internetiniai lošimai (
18.	18.
State aid rules on services of general economic interest (	Valstybės pagalbos taisyklės, susijusios su visuotinės ekonominės svarbos paslaugomis (
Corrections to votes and voting intentions: see Minutes	Balsavimo ketinimai ir pataisymai (žr. protokolą)
(Posiedzenie zostało otwarte o godz.	(Posiedzenie zostało otwarte o godz.
15.00)	15.00)
Request for the defence of parliamentary immunity : see Minutes	Prašymas ginti Parlamento nario imunitetą (žr. protokola)
Approval of the minutes of the previous sitting: see Minutes	Ankstesnio posėdžio protokolų tvirtinimas (žr. protokolą)
Agenda of the next sitting : see Minutes	Kito posėdžio darbotvark(žr. protokola)
Closure of the sitting	Posėdžio pabaiga
Opening of the sitting	Posėdžio pradžia
Przewodniczący	Przewodniczący
(Posiedzenie zostało otwarte o godz.	(Posiedzenie zostało otwarte o godz.
9.00)	9.00)
Documents received: see Minutes	Pateikti dokumentai (žr.protokolą)
Implementing measures (Rule 88): see Minutes	Įgyvendinimo priemonės (Darbo tvarkos taisyklių 88 straipsnis) (žr. protokola)
Delegated acts (Rule 87a): see Minutes	Deleguotieji aktai (Darbo tvarkos taisyklių 87a straipsnis) (žr. protokola)
1.	1.
Mobilisation of the European Globalisation Adjustment Fund: application EGF/2010/019 IE/Construction 41 from Ireland (	Europos prisitaikymo prie globalizacijos padarinių fondo lėšų mobilizavimas (Airijos paraiška "EGF/2010/019 IE/Construction 41") (
2.	2.
Mobilisation of the European Globalisation Adjustment Fund: application EGF/2010/021 IE/Construction 71 from Ireland (	Europos prisitaikymo prie globalizacijos padarinių fondo lėšų mobilizavimas (Airijos paraiška "EGF/2010/021 IE/Construction 71") (
3.	3.
Mobilisation of the European Globalisation Adjustment Fund: application EGF/2010/020 IE/Construction 43 from Ireland (	Europos prisitaikymo prie globalizacijos padarinių fondo lėšų mobilizavimas (Airijos paraiška "EGF/2010/020 IE/Construction 43") (
4.	4.
Mobilisation of the European Globalisation Adjustment Fund: application EGF/2011/001 AT/Lower and Upper Austria/Austria (	Europos prisitaikymo prie globalizacijos padarinių fondo lėšų mobilizavimas (Austrijos paraiška "EGF/2011/001 AT/Niederösterreich- Oberösterreich") (
5.	5.
Mobilisation of the European Globalisation Adjustment Fund: application EGF/2011/004 EL/ALDI Hellas/Greece (	Europos prisitaikymo prie globalizacijos padarinių fondo lėšų mobilizavimas (Graikijos paraiška "EGF/2011/004 EL/ALDI Hellas") (
6.	6.
ACP-EU Joint Parliamentary Assembly in 2010 (	AKR ir ES jungtinės parlamentinės asamblėjos veikla 2010 m. (
7.	7.
European Heritage Label (	Europos paveldo ženklas (
9.	9.
Climate change conference in Durban (	Klimato kaitos konferencija Durbane (
10.	10.
Accountability report on financing for development (	Vystymosi finansavimo ataskaita (
Voting time	Balsuoti skirtas laikas
The next item is the vote.	The next item is the vote.
(For the results and other details on the vote: see Minutes)	(For the results and other details on the vote: see Minutes)
Corrections to votes and voting intentions: see Minutes	Balsavimo ketinimai ir pataisymai (žr. protokolą)
Approval of the minutes of the previous sitting : see Minutes	Ankstesnio posėdžio protokolo tvirtinimas (žr. protokola)
Composition of committees and delegations : see Minutes	Komitetų ir delegacijų sudėtis (žr. protokola)
Agenda of the next sitting : see Minutes	Kito posėdžio darbotvark(žr. protokola)
Closure of the sitting	Posėdžio pabaiga
(The sitting closed at 22.25)	(The sitting closed at 22.25)
. -	. -
